syllables:	1973
'AM	འམ
'ANG	འང
'BA'	འབའ
'BAB	འབབ
'BAD	འབད
'BAR	འབར
'BEB	འབེབ
'BEBS	འབེབས
'BIGS	འབིགས
'BOD	འབོད
'BOGS	འབོགས
'BOR	འབོར
'BRAL	འབྲལ
'BRANG	འབྲང
'BRANGS	འབྲངས
'BRAS	འབྲས
'BREL	འབྲེལ
'BRI	འབྲི
'BRING	འབྲིང
'BROG	འབྲོག
'BROM	འབྲོམ
'BRU	འབྲུ
'BRU'I	འབྲུའི
'BRUG	འབྲུག
'BRUL	འབྲུལ
'BUD	འབུད
'BUL	འབུལ
'BUM	འབུམ
'BUR	འབུར
'BUS	འབུས
'BYAMS	འབྱམས
'BYED	འབྱེད
'BYES	འབྱེས
'BYIN	འབྱིན
'BYOR	འབྱོར
'BYUNG	འབྱུང
'CHA'	འཆའ
'CHAD	འཆད
'CHAG	འཆག
'CHAL	འཆལ
'CHANG	འཆང
'CHAR	འཆར
'CHI	འཆི
'CHING	འཆིང
'CHOL	འཆོལ
'CHOS	འཆོས
'DA'	འདའ
'DAB	འདབ
'DAG	འདག
'DAM	འདམ
'DAS	འདས
'DEBS	འདེབས
'DI	འདི
'DI'ANG	འདིའང
'DI'I	འདིའི
'DI'O	འདིའོ
'DING	འདིང
'DINGS	འདིངས
'DIR	འདིར
'DIS	འདིས
'DOD	འདོད
'DOGS	འདོགས
'DOM	འདོམ
'DOMS	འདོམས
'DON	འདོན
'DOR	འདོར
'DRA	འདྲ
'DRA'ANG	འདྲའང
'DRA'I	འདྲའི
'DRA'O	འདྲའོ
'DRAR	འདྲར
'DRAS	འདྲས
'DREN	འདྲེན
'DRES	འདྲེས
'DRI	འདྲི
'DRIS	འདྲིས
'DU	འདུ
'DUD	འདུད
'DUG	འདུག
'DUL	འདུལ
'DUN	འདུན
'DUR	འདུར
'DUS	འདུས
'DZAD	འཛད
'DZAG	འཛག
'DZAM	འཛམ
'DZEGS	འཛེགས
'DZEMS	འཛེམས
'DZIN	འཛིན
'DZINGS	འཛིངས
'DZIR	འཛིར
'DZUD	འཛུད
'GA'	འགའ
'GAG	འགག
'GAGS	འགགས
'GAL	འགལ
'GAR	འགར
'GEBS	འགེབས
'GEGS	འགེགས
'GO	འགོ
'GOD	འགོད
'GOG	འགོག
'GOM	འགོམ
'GONG	འགོང
'GRAM	འགྲམ
'GRAN	འགྲན
'GRE	འགྲེ
'GRE'O	འགྲེའོ
'GREL	འགྲེལ
'GREN	འགྲེན
'GRES	འགྲེས
'GRIB	འགྲིབ
'GRIG	འགྲིག
'GRIGS	འགྲིགས
'GRO	འགྲོ
'GRO'I	འགྲོའི
'GRO'O	འགྲོའོ
'GROGS	འགྲོགས
'GRON	འགྲོན
'GROR	འགྲོར
'GRUB	འགྲུབ
'GRUS	འགྲུས
'GUL	འགུལ
'GYED	འགྱེད
'GYOD	འགྱོད
'GYUR	འགྱུར
'JA'	འཇའ
'JAL	འཇལ
'JAM	འཇམ
'JI	འཇི
'JIG	འཇིག
'JIGS	འཇིགས
'JIL	འཇིལ
'JOG	འཇོག
'JOMS	འཇོམས
'JUG	འཇུག
'KHAR	འཁར
'KHOD	འཁོད
'KHOR	འཁོར
'KHREN	འཁྲེན
'KHRID	འཁྲིད
'KHRIL	འཁྲིལ
'KHRUG	འཁྲུག
'KHRUGS	འཁྲུགས
'KHRUL	འཁྲུལ
'KHRUNGS	འཁྲུངས
'KHUL	འཁུལ
'KHUR	འཁུར
'KHYAM	འཁྱམ
'KHYAMS	འཁྱམས
'KHYER	འཁྱེར
'KHYIL	འཁྱིལ
'KHYOG	འཁྱོག
'O	འོ
'OD	འོད
'OG	འོག
'ON	འོན
'ONG	འོང
'ONGS	འོངས
'OS	འོས
'PHAGS	འཕགས
'PHAM	འཕམ
'PHANG	འཕང
'PHANGS	འཕངས
'PHAR	འཕར
'PHEL	འཕེལ
'PHEN	འཕེན
'PHO	འཕོ
'PHONGS	འཕོངས
'PHOS	འཕོས
'PHRAD	འཕྲད
'PHRAL	འཕྲལ
'PHRENG	འཕྲེང
'PHRIN	འཕྲིན
'PHRO	འཕྲོ
'PHROD	འཕྲོད
'PHROG	འཕྲོག
'PHROGS	འཕྲོགས
'PHROS	འཕྲོས
'PHRUL	འཕྲུལ
'PHUL	འཕུལ
'PHUR	འཕུར
'PHYAN	འཕྱན
'PHYI	འཕྱི
'PHYUG	འཕྱུག
'PHYUGS	འཕྱུགས
'THAD	འཐད
'THAG	འཐག
'THEB	འཐེབ
'THIBS	འཐིབས
'THOB	འཐོབ
'THON	འཐོན
'THOR	འཐོར
'THUG	འཐུག
'THUNG	འཐུང
'TSAL	འཚལ
'TSAM	འཚམ
'TSAMS	འཚམས
'TSANG	འཚང
'TSIG	འཚིག
'TSO	འཚོ
'TSO'I	འཚོའི
'TSOL	འཚོལ
'TSUM	འཚུམ
'UG	འུག
A'A	ཨཱ
A'ARYA	ཨཱརྱ
AA	ཨ
AE	ཨེ
AI	ཨི
AOM	ཨོམ
AUTPA	ཨུཏྤ
AUTPAL	ཨུཏྤལ
AUTPALA'I	ཨུཏྤལའི
AUTTA	ཨུཏྟ
Ai	ཨྀ
Am	ཨ
B'A	བཱ
BA	བ
BA'AM	བའམ
BA'ANG	བའང
BA'I	བའི
BA'O	བའོ
BAB	བབ
BABS	བབས
BAD	བད
BADZRA	བཛྲ
BADZRAS	བཛྲས
BAG	བག
BAL	བལ
BAM	བམ
BANDE	བནྡེ
BAR	བར
BAS	བས
BCA'	བཅའ
BCA'I	བཅའི
BCA'O	བཅའོ
BCAD	བཅད
BCAS	བཅས
BCING	བཅིང
BCINGS	བཅིངས
BCO	བཅོ
BCOL	བཅོལ
BCOM	བཅོམ
BCOS	བཅོས
BCU	བཅུ
BCU'I	བཅུའི
BCUD	བཅུད
BCUG	བཅུག
BCUR	བཅུར
BCVO	བཅྭོ
BDAG	བདག
BDAR	བདར
BDE	བདེ
BDE'I	བདེའི
BDE'O	བདེའོ
BDEN	བདེན
BDER	བདེར
BDO	བདོ
BDOG	བདོག
BDUD	བདུད
BDUN	བདུན
BE'U	བེའུ
BEE	བཻ
BEM	བེམ
BGO	བགོ
BGOM	བགོམ
BGOS	བགོས
BGRANG	བགྲང
BGROD	བགྲོད
BGYI	བགྱི
BGYI'O	བགྱིའོ
BGYID	བགྱིད
BGYIS	བགྱིས
BH'A	བྷཱ
BHI	བྷི
BHY'A	བྷྱཱ
BIMPA	བིམྤ
BKA'	བཀའ
BKAB	བཀབ
BKAG	བཀག
BKANG	བཀང
BKAR	བཀར
BKAS	བཀས
BKOD	བཀོད
BKON	བཀོན
BKRA	བཀྲ
BKRA'I	བཀྲའི
BKRAL	བཀྲལ
BKREN	བཀྲེན
BKRES	བཀྲེས
BKRI	བཀྲི
BKRIS	བཀྲིས
BKROL	བཀྲོལ
BKRUS	བཀྲུས
BKUR	བཀུར
BLA	བླ
BLAG	བླག
BLANG	བླང
BLANGS	བླངས
BLO	བློ
BLO'AM	བློའམ
BLO'I	བློའི
BLON	བློན
BLOR	བློར
BLOS	བློས
BLTA	བལྟ
BLTA'O	བལྟའོ
BLTAM	བལྟམ
BLTAMS	བལྟམས
BLTAR	བལྟར
BLTAS	བལྟས
BLTOS	བལྟོས
BLUGS	བླུགས
BLUN	བླུན
BO	བོ
BO'AM	བོའམ
BO'ANG	བོའང
BO'I	བོའི
BO'O	བོའོ
BOD	བོད
BON	བོན
BONG	བོང
BOR	བོར
BOS	བོས
BRA	བྲ
BRAG	བྲག
BRAL	བྲལ
BRAM	བྲམ
BRAN	བྲན
BRDA	བརྡ
BRDA'	བརྡའ
BRDA'I	བརྡའི
BRDAS	བརྡས
BRDEG	བརྡེག
BRDEGS	བརྡེགས
BRDOL	བརྡོལ
BRDOS	བརྡོས
BRDZI	བརྫི
BRDZUN	བརྫུན
BRDZUS	བརྫུས
BREGS	བྲེགས
BRGAL	བརྒལ
BRGYA	བརྒྱ
BRGYAD	བརྒྱད
BRGYAL	བརྒྱལ
BRGYAN	བརྒྱན
BRGYAR	བརྒྱར
BRGYAS	བརྒྱས
BRGYUD	བརྒྱུད
BRI	བྲི
BRIS	བྲིས
BRJE	བརྗེ
BRJED	བརྗེད
BRJID	བརྗིད
BRJOD	བརྗོད
BRKAM	བརྐམ
BRKUS	བརྐུས
BRKYAL	བརྐྱལ
BRLABS	བརླབས
BRLAG	བརླག
BRLAN	བརླན
BRLING	བརླིང
BRLOBS	བརློབས
BRLOM	བརློམ
BRNAB	བརྣབ
BRNYAN	བརྙན
BRNYAS	བརྙས
BRNYES	བརྙེས
BRO	བྲོ
BRTAG	བརྟག
BRTAGS	བརྟགས
BRTAN	བརྟན
BRTEN	བརྟེན
BRTUL	བརྟུལ
BRTZAD	བརྩད
BRTZAL	བརྩལ
BRTZAM	བརྩམ
BRTZAMS	བརྩམས
BRTZE	བརྩེ
BRTZE'I	བརྩེའི
BRTZEGS	བརྩེགས
BRTZER	བརྩེར
BRTZIS	བརྩིས
BRTZOM	བརྩོམ
BRTZON	བརྩོན
BSAG	བསག
BSAGS	བསགས
BSAL	བསལ
BSAM	བསམ
BSAMS	བསམས
BSANGS	བསངས
BSDAD	བསྡད
BSDAMS	བསྡམས
BSDOD	བསྡོད
BSDOMS	བསྡོམས
BSDU	བསྡུ
BSDU'I	བསྡུའི
BSDU'O	བསྡུའོ
BSDUR	བསྡུར
BSDUS	བསྡུས
BSE	བསེ
BSGO	བསྒོ
BSGOM	བསྒོམ
BSGOMS	བསྒོམས
BSGOS	བསྒོས
BSGRAG	བསྒྲག
BSGRAGS	བསྒྲགས
BSGRE	བསྒྲེ
BSGRENG	བསྒྲེང
BSGRIBS	བསྒྲིབས
BSGRIGS	བསྒྲིགས
BSGRIL	བསྒྲིལ
BSGRIM	བསྒྲིམ
BSGRUB	བསྒྲུབ
BSGRUBS	བསྒྲུབས
BSGYINGS	བསྒྱིངས
BSGYUR	བསྒྱུར
BSHAD	བཤད
BSHAGS	བཤགས
BSHAMS	བཤམས
BSHES	བཤེས
BSHIG	བཤིག
BSHOR	བཤོར
BSIL	བསིལ
BSKAL	བསྐལ
BSKAMS	བསྐམས
BSKANG	བསྐང
BSKOR	བསྐོར
BSKRUN	བསྐྲུན
BSKUL	བསྐུལ
BSKUR	བསྐུར
BSKUS	བསྐུས
BSKYAB	བསྐྱབ
BSKYAL	བསྐྱལ
BSKYANG	བསྐྱང
BSKYANGS	བསྐྱངས
BSKYED	བསྐྱེད
BSKYOB	བསྐྱོབ
BSKYOD	བསྐྱོད
BSLAB	བསླབ
BSLABS	བསླབས
BSLAD	བསླད
BSLANGS	བསླངས
BSLU	བསླུ
BSNAMS	བསྣམས
BSNAN	བསྣན
BSNGAGS	བསྔགས
BSNGAL	བསྔལ
BSNGO	བསྔོ
BSNGOS	བསྔོས
BSNOR	བསྣོར
BSNYAD	བསྙད
BSNYEL	བསྙེལ
BSNYEN	བསྙེན
BSNYES	བསྙེས
BSNYON	བསྙོན
BSOD	བསོད
BSOG	བསོག
BSRABS	བསྲབས
BSRANG	བསྲང
BSREG	བསྲེག
BSREGS	བསྲེགས
BSRES	བསྲེས
BSRINGS	བསྲིངས
BSRUNG	བསྲུང
BSRUNGS	བསྲུངས
BSTAMS	བསྟམས
BSTAN	བསྟན
BSTANG	བསྟང
BSTEN	བསྟེན
BSTI	བསྟི
BSTOD	བསྟོད
BSTUN	བསྟུན
BTAB	བཏབ
BTAGS	བཏགས
BTANG	བཏང
BTON	བཏོན
BTUB	བཏུབ
BTUD	བཏུད
BTUNG	བཏུང
BTUS	བཏུས
BTZAL	བཙལ
BTZAN	བཙན
BTZAS	བཙས
BTZON	བཙོན
BTZUGS	བཙུགས
BTZUN	བཙུན
BU	བུ
BU'AM	བུའམ
BU'ANG	བུའང
BU'I	བུའི
BU'O	བུའོ
BUD	བུད
BUDDHA	བུདྡྷ
BUL	བུལ
BUM	བུམ
BUNG	བུང
BUR	བུར
BUS	བུས
BYA	བྱ
BYA'ANG	བྱའང
BYA'I	བྱའི
BYA'O	བྱའོ
BYAD	བྱད
BYAMS	བྱམས
BYANG	བྱང
BYANGS	བྱངས
BYAR	བྱར
BYAS	བྱས
BYE	བྱེ
BYED	བྱེད
BYI	བྱི
BYI'U	བྱིའུ
BYIN	བྱིན
BYING	བྱིང
BYINGS	བྱིངས
BYIS	བྱིས
BYON	བྱོན
BYOS	བྱོས
BYUG	བྱུག
BYUNG	བྱུང
BZA'	བཟའ
BZAD	བཟད
BZANG	བཟང
BZED	བཟེད
BZHAG	བཞག
BZHED	བཞེད
BZHENGS	བཞེངས
BZHES	བཞེས
BZHI	བཞི
BZHI'I	བཞིའི
BZHI'O	བཞིའོ
BZHIN	བཞིན
BZHIR	བཞིར
BZHIS	བཞིས
BZHON	བཞོན
BZHOS	བཞོས
BZHUGS	བཞུགས
BZLA'O	བཟླའོ
BZLAS	བཟླས
BZLOG	བཟློག
BZO	བཟོ
BZOD	བཟོད
BZUNG	བཟུང
CA	ཅ
CAD	ཅད
CAG	ཅག
CAN	ཅན
CANG	ཅང
CAR	ཅར
CE	ཅེ
CES	ཅེས
CHA	ཆ
CHA'I	ཆའི
CHAD	ཆད
CHAG	ཆག
CHAGS	ཆགས
CHANG	ཆང
CHAR	ཆར
CHAS	ཆས
CHE	ཆེ
CHE'I	ཆེའི
CHE'O	ཆེའོ
CHED	ཆེད
CHEN	ཆེན
CHER	ཆེར
CHES	ཆེས
CHO	ཆོ
CHOD	ཆོད
CHOG	ཆོག
CHOM	ཆོམ
CHOS	ཆོས
CHU	ཆུ
CHU'I	ཆུའི
CHUB	ཆུབ
CHUD	ཆུད
CHUG	ཆུག
CHUN	ཆུན
CHUNG	ཆུང
CHUR	ཆུར
CHUS	ཆུས
CI	ཅི
CI'ANG	ཅིའང
CI'I	ཅིའི
CIG	ཅིག
CING	ཅིང
CIR	ཅིར
CIS	ཅིས
CO	ཅོ
COG	ཅོག
CU	ཅུ
CU'I	ཅུའི
CUNG	ཅུང
D'UR	དཱུར
D'URYA	དཱུརྱ
DA	ད
DAD	དད
DAG	དག
DAGS	དགས
DAL	དལ
DAM	དམ
DANG	དང
DANGS	དངས
DAR	དར
DBAB	དབབ
DBANG	དབང
DBEN	དབེན
DBU	དབུ
DBUGS	དབུགས
DBUL	དབུལ
DBUR	དབུར
DBUS	དབུས
DBYANGS	དབྱངས
DBYAR	དབྱར
DBYE	དབྱེ
DBYE'I	དབྱེའི
DBYER	དབྱེར
DBYES	དབྱེས
DBYIBS	དབྱིབས
DBYIG	དབྱིག
DBYINGS	དབྱིངས
DBYU	དབྱུ
DBYUG	དབྱུག
DBYUNG	དབྱུང
DE	དེ
DE'ANG	དེའང
DE'I	དེའི
DE'O	དེའོ
DEB	དེབ
DED	དེད
DENG	དེང
DER	དེར
DES	དེས
DGA'	དགའ
DGA'I	དགའི
DGAG	དགག
DGAS	དགས
DGE	དགེ
DGE'I	དགེའི
DGE'O	དགེའོ
DGOD	དགོད
DGON	དགོན
DGONGS	དགོངས
DGOS	དགོས
DGRA	དགྲ
DGROL	དགྲོལ
DGU	དགུ
DGU'I	དགུའི
DGUN	དགུན
DGUR	དགུར
DGYES	དགྱེས
DHA	དྷ
DHARMA	དྷརྨ
DHY'A	དྷྱཱ
DI	དི
DKA'	དཀའ
DKA'I	དཀའི
DKA'O	དཀའོ
DKAR	དཀར
DKON	དཀོན
DKRI	དཀྲི
DKRIS	དཀྲིས
DKROL	དཀྲོལ
DKRUG	དཀྲུག
DKRUGS	དཀྲུགས
DKU	དཀུ
DKYIL	དཀྱིལ
DKYUS	དཀྱུས
DMA'	དམའ
DMAG	དམག
DMAN	དམན
DMANGS	དམངས
DMAR	དམར
DMIGS	དམིགས
DMUGS	དམུགས
DMUS	དམུས
DMYAL	དམྱལ
DNGANG	དངང
DNGOS	དངོས
DNGUL	དངུལ
DO	དོ
DOD	དོད
DOG	དོག
DOGS	དོགས
DON	དོན
DONG	དོང
DOR	དོར
DPA'	དཔའ
DPA'I	དཔའི
DPAG	དཔག
DPAGS	དཔགས
DPAL	དཔལ
DPAR	དཔར
DPAS	དཔས
DPE	དཔེ
DPE'I	དཔེའི
DPER	དཔེར
DPES	དཔེས
DPOG	དཔོག
DPOGS	དཔོགས
DPON	དཔོན
DPRAL	དཔྲལ
DPUNG	དཔུང
DPYAD	དཔྱད
DPYID	དཔྱིད
DPYIS	དཔྱིས
DPYOD	དཔྱོད
DRA	དྲ
DRAG	དྲག
DRAN	དྲན
DRANG	དྲང
DRANGS	དྲངས
DRES	དྲེས
DRI	དྲི
DRIL	དྲིལ
DRIN	དྲིན
DRIS	དྲིས
DRO	དྲོ
DRO'I	དྲོའི
DROD	དྲོད
DROR	དྲོར
DROS	དྲོས
DRUG	དྲུག
DRUNG	དྲུང
DRUNGS	དྲུངས
DRUS	དྲུས
DU	དུ
DU'ANG	དུའང
DU'O	དུའོ
DUB	དུབ
DUD	དུད
DUG	དུག
DUL	དུལ
DUM	དུམ
DUNG	དུང
DUS	དུས
DVAGS	དྭགས
DVANG	དྭང
DVANGS	དྭངས
DVOGS	དྭོགས
DZNY'A	ཛྙཱ
G'A'I	གཱའི
GA	ག
GA'I	གའི
GA-YA'	གཡའ
GA-YANG	གཡང
GA-YAS	གཡས
GA-YEL	གཡེལ
GA-YENG	གཡེང
GA-YENGS	གཡེངས
GA-YO	གཡོ
GA-YO'I	གཡོའི
GA-YOG	གཡོག
GA-YOGS	གཡོགས
GA-YON	གཡོན
GA-YOS	གཡོས
GA-YUL	གཡུལ
GA-YUNG	གཡུང
GAB	གབ
GAD	གད
GAL	གལ
GAM	གམ
GANG	གང
GANGG'A	གངྒཱ
GANGG'A'I	གངྒཱའི
GANGS	གངས
GAR	གར
GARBHA	གརྦྷ
GAS	གས
GCAD	གཅད
GCAN	གཅན
GCER	གཅེར
GCES	གཅེས
GCI	གཅི
GCIG	གཅིག
GCOD	གཅོད
GDAGS	གདགས
GDAM	གདམ
GDAMS	གདམས
GDAN	གདན
GDANGS	གདངས
GDEGS	གདེགས
GDENGS	གདེངས
GDOD	གདོད
GDON	གདོན
GDONG	གདོང
GDUG	གདུག
GDUL	གདུལ
GDUNG	གདུང
GDUNGS	གདུངས
GE	གེ
GE'I	གེའི
GEGS	གེགས
GHO	གྷོ
GHOSH'A	གྷོཤཱ
GI	གི
GI'AM	གིའམ
GI'O	གིའོ
GIR	གིར
GIS	གིས
GLAGS	གླགས
GLANG	གླང
GLEGS	གླེགས
GLENG	གླེང
GLING	གླིང
GLO	གློ
GLOG	གློག
GLU	གླུ
GNAD	གནད
GNAG	གནག
GNAM	གནམ
GNANG	གནང
GNAS	གནས
GNOD	གནོད
GNON	གནོན
GNYEN	གཉེན
GNYER	གཉེར
GNYI	གཉི
GNYID	གཉིད
GNYIS	གཉིས
GNYOG	གཉོག
GNYUG	གཉུག
GO	གོ
GO'U	གོའུ
GOGS	གོགས
GOL	གོལ
GOM	གོམ
GOMS	གོམས
GONG	གོང
GOO	གཽ
GOR	གོར
GOS	གོས
GRA	གྲ
GRAG	གྲག
GRAGS	གྲགས
GRANG	གྲང
GRANGS	གྲངས
GRI	གྲི
GRI'I	གྲིའི
GRIB	གྲིབ
GRIMS	གྲིམས
GRIS	གྲིས
GRO	གྲོ
GROGS	གྲོགས
GROL	གྲོལ
GRONG	གྲོང
GRONGS	གྲོངས
GROS	གྲོས
GRU	གྲུ
GRUB	གྲུབ
GRVA	གྲྭ
GRVA'I	གྲྭའི
GSAD	གསད
GSAL	གསལ
GSAN	གསན
GSANG	གསང
GSAR	གསར
GSEB	གསེབ
GSER	གསེར
GSHA'	གཤའ
GSHAM	གཤམ
GSHE	གཤེ
GSHED	གཤེད
GSHEGS	གཤེགས
GSHER	གཤེར
GSHIS	གཤིས
GSHOG	གཤོག
GSIL	གསིལ
GSO	གསོ
GSOD	གསོད
GSOG	གསོག
GSOL	གསོལ
GSON	གསོན
GSOS	གསོས
GSUM	གསུམ
GSUNG	གསུང
GSUNGS	གསུངས
GTAD	གཏད
GTAM	གཏམ
GTAN	གཏན
GTANG	གཏང
GTER	གཏེར
GTI	གཏི
GTING	གཏིང
GTOD	གཏོད
GTOGS	གཏོགས
GTONG	གཏོང
GTOR	གཏོར
GTUG	གཏུག
GTUGS	གཏུགས
GTUMS	གཏུམས
GTZANG	གཙང
GTZO	གཙོ
GTZOR	གཙོར
GTZUB	གཙུབ
GTZUBS	གཙུབས
GTZUG	གཙུག
GU	གུ
GU'I	གུའི
GUR	གུར
GUS	གུས
GYA	གྱ
GYAL	གྱལ
GYEN	གྱེན
GYI	གྱི
GYI'ANG	གྱིའང
GYIS	གྱིས
GYON	གྱོན
GYU	གྱུ
GYUR	གྱུར
GZA'	གཟའ
GZAR	གཟར
GZAS	གཟས
GZEGS	གཟེགས
GZHAG	གཞག
GZHAL	གཞལ
GZHAN	གཞན
GZHAR	གཞར
GZHI	གཞི
GZHI'I	གཞིའི
GZHIR	གཞིར
GZHOG	གཞོག
GZHOL	གཞོལ
GZHOM	གཞོམ
GZHON	གཞོན
GZHONG	གཞོང
GZHUG	གཞུག
GZHUNG	གཞུང
GZI	གཟི
GZIGS	གཟིགས
GZIMS	གཟིམས
GZINGS	གཟིངས
GZO	གཟོ
GZOD	གཟོད
GZUGS	གཟུགས
GZUNG	གཟུང
GZUNGS	གཟུངས
GZUR	གཟུར
H'A	ཧཱ
HA	ཧ
HAN	ཧན
HRIL	ཧྲིལ
HRUL	ཧྲུལ
HUD	ཧུད
HVA	ཧྭ
JE	ཇེ
JI	ཇི
JIG	ཇིག
JO	ཇོ
K'A	ཀཱ
KA	ཀ
KA'ANG	ཀའང
KA'I	ཀའི
KAN	ཀན
KAR	ཀར
KAS	ཀས
KENG	ཀེང
KHA	ཁ
KHA'I	ཁའི
KHAB	ཁབ
KHAMS	ཁམས
KHANG	ཁང
KHAS	ཁས
KHEBS	ཁེབས
KHEGS	ཁེགས
KHENGS	ཁེངས
KHO	ཁོ
KHO'I	ཁོའི
KHOG	ཁོག
KHONG	ཁོང
KHONGS	ཁོངས
KHRA	ཁྲ
KHRA'I	ཁྲའི
KHRAB	ཁྲབ
KHRAG	ཁྲག
KHREL	ཁྲེལ
KHRI	ཁྲི
KHRI'I	ཁྲིའི
KHRID	ཁྲིད
KHRIG	ཁྲིག
KHRIMS	ཁྲིམས
KHRO	ཁྲོ
KHRO'I	ཁྲོའི
KHROD	ཁྲོད
KHRON	ཁྲོན
KHROS	ཁྲོས
KHRU	ཁྲུ
KHRUS	ཁྲུས
KHU	ཁུ
KHUNG	ཁུང
KHUNGS	ཁུངས
KHUR	ཁུར
KHYAB	ཁྱབ
KHYAD	ཁྱད
KHYE'U	ཁྱེའུ
KHYED	ཁྱེད
KHYER	ཁྱེར
KHYI	ཁྱི
KHYI'U	ཁྱིའུ
KHYIM	ཁྱིམ
KHYOD	ཁྱོད
KHYON	ཁྱོན
KHYU	ཁྱུ
KLAD	ཀླད
KLAGS	ཀླགས
KLAN	ཀླན
KLAS	ཀླས
KLOG	ཀློག
KLU	ཀླུ
KLU'I	ཀླུའི
KLUNG	ཀླུང
KO	ཀོ
KRUNG	ཀྲུང
KU	ཀུ
KUN	ཀུན
KYANG	ཀྱང
KYE	ཀྱེ
KYEE	ཀྱཻ
KYI	ཀྱི
KYIR	ཀྱིར
KYIS	ཀྱིས
LA	ལ
LA'ANG	ལའང
LA'I	ལའི
LA'O	ལའོ
LAG	ལག
LAGS	ལགས
LAM	ལམ
LAN	ལན
LANG	ལང
LANGS	ལངས
LAR	ལར
LAS	ལས
LCAG	ལྕག
LCAGS	ལྕགས
LCANG	ལྕང
LCE	ལྕེ
LCE'I	ལྕེའི
LCI	ལྕི
LDABS	ལྡབས
LDAN	ལྡན
LDANG	ལྡང
LDE	ལྡེ
LDE'U	ལྡེའུ
LDING	ལྡིང
LDIR	ལྡིར
LDOG	ལྡོག
LDONGS	ལྡོངས
LE	ལེ
LE'U	ལེའུ
LE'U'I	ལེའུའི
LE'UR	ལེའུར
LE'US	ལེའུས
LEGS	ལེགས
LEN	ལེན
LHA	ལྷ
LHA'I	ལྷའི
LHAG	ལྷག
LHAGS	ལྷགས
LHAM	ལྷམ
LHAN	ལྷན
LHAR	ལྷར
LHAS	ལྷས
LHO	ལྷོ
LHUMS	ལྷུམས
LHUN	ལྷུན
LHUNG	ལྷུང
LHUR	ལྷུར
LI	ལི
LING	ལིང
LJAGS	ལྗགས
LJAN	ལྗན
LJANG	ལྗང
LJIN	ལྗིན
LJON	ལྗོན
LKOG	ལྐོག
LNGA	ལྔ
LNGA'I	ལྔའི
LNGA'O	ལྔའོ
LNGAR	ལྔར
LNGAS	ལྔས
LO	ལོ
LO'ANG	ལོའང
LO'I	ལོའི
LOG	ལོག
LOGS	ལོགས
LON	ལོན
LONG	ལོང
LONGS	ལོངས
LOR	ལོར
LOS	ལོས
LPAGS	ལྤགས
LTA	ལྟ
LTA'ANG	ལྟའང
LTA'I	ལྟའི
LTA'O	ལྟའོ
LTAD	ལྟད
LTAG	ལྟག
LTAR	ལྟར
LTAS	ལྟས
LTE	ལྟེ
LTO	ལྟོ
LTOS	ལྟོས
LTUNG	ལྟུང
LU	ལུ
LU'I	ལུའི
LUD	ལུད
LUGS	ལུགས
LUNG	ལུང
LUS	ལུས
LVA	ལྭ
M'U	མཱུ
MA	མ
MA'ANG	མའང
MA'I	མའི
MA'O	མའོ
MAL	མལ
MAM	མམ
MAN	མན
MANG	མང
MANGGA	མངྒ
MANGS	མངས
MANYDZU	མཉྫུ
MAR	མར
MAS	མས
MCHE	མཆེ
MCHED	མཆེད
MCHI	མཆི
MCHI'O	མཆིའོ
MCHIS	མཆིས
MCHOD	མཆོད
MCHOG	མཆོག
MCHU	མཆུ
MDA'	མདའ
MDA'I	མདའི
MDANGS	མདངས
MDO	མདོ
MDO'I	མདོའི
MDOG	མདོག
MDOMS	མདོམས
MDONGS	མདོངས
MDOR	མདོར
MDOS	མདོས
MDUD	མདུད
MDUN	མདུན
MDUNG	མདུང
MDZA'	མཛའ
MDZAD	མཛད
MDZANGS	མཛངས
MDZES	མཛེས
MDZOD	མཛོད
ME	མེ
ME'I	མེའི
MED	མེད
MES	མེས
MGAL	མགལ
MGO	མགོ
MGON	མགོན
MGOR	མགོར
MGOS	མགོས
MGRIN	མགྲིན
MGU	མགུ
MGUR	མགུར
MI	མི
MI'I	མིའི
MIG	མིག
MIN	མིན
MING	མིང
MIR	མིར
MIS	མིས
MJAL	མཇལ
MJUG	མཇུག
MKHA'	མཁའ
MKHA'I	མཁའི
MKHAN	མཁན
MKHAR	མཁར
MKHAS	མཁས
MKHO	མཁོ
MKHREGS	མཁྲེགས
MKHRIS	མཁྲིས
MKHYEN	མཁྱེན
MKHYUD	མཁྱུད
MNA'	མནའ
MNAL	མནལ
MNAR	མནར
MNGA'	མངའ
MNGA'I	མངའི
MNGAL	མངལ
MNGAR	མངར
MNGON	མངོན
MNYAM	མཉམ
MNYAN	མཉན
MNYEN	མཉེན
MNYES	མཉེས
MO	མོ
MO'I	མོའི
MOD	མོད
MOG	མོག
MONG	མོང
MONGS	མོངས
MOR	མོར
MOS	མོས
MRA	མྲ
MRA'I	མྲའི
MTHA'	མཐའ
MTHA'I	མཐའི
MTHAR	མཐར
MTHAS	མཐས
MTHIL	མཐིལ
MTHING	མཐིང
MTHO	མཐོ
MTHO'I	མཐོའི
MTHON	མཐོན
MTHONG	མཐོང
MTHU	མཐུ
MTHU'I	མཐུའི
MTHUN	མཐུན
MTHUS	མཐུས
MTSAMS	མཚམས
MTSAN	མཚན
MTSAR	མཚར
MTSO	མཚོ
MTSO'I	མཚོའི
MTSON	མཚོན
MTSOR	མཚོར
MTSOS	མཚོས
MTSUNGS	མཚུངས
MU	མུ
MUG	མུག
MUN	མུན
MUR	མུར
MYA	མྱ
MYAGS	མྱགས
MYANG	མྱང
MYANGS	མྱངས
MYONG	མྱོང
MYOS	མྱོས
MYU	མྱུ
MYUG	མྱུག
MYUR	མྱུར
N'A	ནཱ
NA	ན
NA'ANG	ནའང
NA'I	ནའི
NA'O	ནའོ
NAD	ནད
NAG	ནག
NAGS	ནགས
NAM	ནམ
NAMS	ནམས
NAN	ནན
NANG	ནང
NAR	ནར
NAS	ནས
NE	ནེ
NGA	ང
NGA'AM	ངའམ
NGA'I	ངའི
NGA'O	ངའོ
NGAG	ངག
NGAL	ངལ
NGAM	ངམ
NGAN	ངན
NGANG	ངང
NGAR	ངར
NGAS	ངས
NGE	ངེ
NGED	ངེད
NGES	ངེས
NGO	ངོ
NGOGS	ངོགས
NGOMS	ངོམས
NGOR	ངོར
NGOS	ངོས
NGU	ངུ
NGU'I	ངུའི
NGUR	ངུར
NI	ནི
NO	ནོ
NOD	ནོད
NOM	ནོམ
NON	ནོན
NONGS	ནོངས
NOR	ནོར
NU	ནུ
NUB	ནུབ
NUR	ནུར
NUS	ནུས
NYA	ཉ
NYAG	ཉག
NYAL	ཉལ
NYAM	ཉམ
NYAMS	ཉམས
NYAN	ཉན
NYE	ཉེ
NYEN	ཉེན
NYER	ཉེར
NYES	ཉེས
NYI	ཉི
NYI'I	ཉིའི
NYID	ཉིད
NYIN	ཉིན
NYING	ཉིང
NYIS	ཉིས
NYON	ཉོན
NYUNG	ཉུང
P'A	པཱ
PA	པ
PA'AM	པའམ
PA'ANG	པའང
PA'I	པའི
PA'O	པའོ
PAD	པད
PADMA	པདྨ
PADMA'I	པདྨའི
PADMO	པདྨོ
PAGS	པགས
PANDI	པནྡི
PAR	པར
PAS	པས
PHA	ཕ
PHAB	ཕབ
PHABS	ཕབས
PHAG	ཕག
PHAL	ཕལ
PHAM	ཕམ
PHAN	ཕན
PHANGS	ཕངས
PHAR	ཕར
PHAS	ཕས
PHEBS	ཕེབས
PHO	ཕོ
PHONGS	ཕོངས
PHOR	ཕོར
PHRA	ཕྲ
PHRAD	ཕྲད
PHRAG	ཕྲག
PHRAN	ཕྲན
PHRENG	ཕྲེང
PHRIN	ཕྲིན
PHROGS	ཕྲོགས
PHRUG	ཕྲུག
PHUG	ཕུག
PHUGS	ཕུགས
PHUL	ཕུལ
PHUN	ཕུན
PHUNG	ཕུང
PHYAG	ཕྱག
PHYANG	ཕྱང
PHYE	ཕྱེ
PHYED	ཕྱེད
PHYI	ཕྱི
PHYI'I	ཕྱིའི
PHYIN	ཕྱིན
PHYIR	ཕྱིར
PHYIS	ཕྱིས
PHYOGS	ཕྱོགས
PHYUG	ཕྱུག
PHYUNG	ཕྱུང
PHYUNGS	ཕྱུངས
PING	པིང
PO	པོ
PO'AM	པོའམ
PO'ANG	པོའང
PO'I	པོའི
PO'O	པོའོ
POR	པོར
POS	པོས
PRA	པྲ
PRADZNY'A	པྲཛྙཱ
PU	པུ
PUR	པུར
PUS	པུས
RA	ར
RAB	རབ
RABS	རབས
RAG	རག
RAGS	རགས
RAL	རལ
RAM	རམ
RANG	རང
RAS	རས
RBA	རྦ
RDE	རྡེ
RDE'U	རྡེའུ
RDO	རྡོ
RDOG	རྡོག
RDUL	རྡུལ
RDZA	རྫ
RDZAS	རྫས
RDZI	རྫི
RDZING	རྫིང
RDZOB	རྫོབ
RDZOGS	རྫོགས
RDZU	རྫུ
RDZUL	རྫུལ
RDZUN	རྫུན
RDZUS	རྫུས
RE	རེ
RE'ANG	རེའང
RE'I	རེའི
RED	རེད
REG	རེག
RER	རེར
RES	རེས
RGA	རྒ
RGA'O	རྒའོ
RGAL	རྒལ
RGAN	རྒན
RGAS	རྒས
RGOD	རྒོད
RGOL	རྒོལ
RGU'I	རྒུའི
RGUD	རྒུད
RGYA	རྒྱ
RGYA'I	རྒྱའི
RGYA'O	རྒྱའོ
RGYAB	རྒྱབ
RGYAGS	རྒྱགས
RGYAL	རྒྱལ
RGYAN	རྒྱན
RGYANG	རྒྱང
RGYANGS	རྒྱངས
RGYAS	རྒྱས
RGYU	རྒྱུ
RGYU'I	རྒྱུའི
RGYUD	རྒྱུད
RGYUG	རྒྱུག
RGYUN	རྒྱུན
RGYUR	རྒྱུར
RGYUS	རྒྱུས
RI	རི
RI'I	རིའི
RIB	རིབ
RIG	རིག
RIGS	རིགས
RIL	རིལ
RIM	རིམ
RIMS	རིམས
RIN	རིན
RING	རིང
RIS	རིས
RJE	རྗེ
RJE'ANG	རྗེའང
RJE'I	རྗེའི
RJER	རྗེར
RJES	རྗེས
RJOD	རྗོད
RKANG	རྐང
RKUB	རྐུབ
RKUN	རྐུན
RKYA	རྐྱ
RKYANG	རྐྱང
RKYEN	རྐྱེན
RLABS	རླབས
RLAN	རླན
RLOB	རློབ
RLOM	རློམ
RLUNG	རླུང
RMA	རྨ
RMAD	རྨད
RMAS	རྨས
RMI	རྨི
RMIG	རྨིག
RMIS	རྨིས
RMONGS	རྨོངས
RMOS	རྨོས
RMUGS	རྨུགས
RNA	རྣ
RNAG	རྣག
RNAL	རྣལ
RNAM	རྣམ
RNAMS	རྣམས
RNAR	རྣར
RNGA	རྔ
RNGAS	རྔས
RNO	རྣོ
RNON	རྣོན
RNYED	རྙེད
RNYING	རྙིང
RNYOG	རྙོག
RNYONGS	རྙོངས
RO	རོ
ROG	རོག
ROL	རོལ
ROR	རོར
RTA	རྟ
RTA'I	རྟའི
RTAG	རྟག
RTAGS	རྟགས
RTAR	རྟར
RTEN	རྟེན
RTING	རྟིང
RTOG	རྟོག
RTOGS	རྟོགས
RTON	རྟོན
RTUL	རྟུལ
RTZA	རྩ
RTZA'I	རྩའི
RTZAD	རྩད
RTZAL	རྩལ
RTZAM	རྩམ
RTZE	རྩེ
RTZE'I	རྩེའི
RTZED	རྩེད
RTZER	རྩེར
RTZI	རྩི
RTZI'I	རྩིའི
RTZIG	རྩིག
RTZINGS	རྩིངས
RTZIR	རྩིར
RTZIS	རྩིས
RTZOD	རྩོད
RTZOL	རྩོལ
RTZOM	རྩོམ
RTZOMS	རྩོམས
RTZUB	རྩུབ
RTZVA	རྩྭ
RTZVA'I	རྩྭའི
RU	རུ
RU'I	རུའི
RUL	རུལ
RUNG	རུང
RUS	རུས
RVA	རྭ
RVA'I	རྭའི
S'A	སཱ
S'U	སཱུ
SA	ས
SA'I	སའི
SAD	སད
SAL	སལ
SAM	སམ
SANG	སང
SANGS	སངས
SAR	སར
SARBA	སརྦ
SAS	སས
SBA	སྦ
SBAGS	སྦགས
SBAL	སྦལ
SBAS	སྦས
SBRANG	སྦྲང
SBRUL	སྦྲུལ
SBUBS	སྦུབས
SBUN	སྦུན
SBYANG	སྦྱང
SBYANGS	སྦྱངས
SBYAR	སྦྱར
SBYIN	སྦྱིན
SBYONG	སྦྱོང
SBYOR	སྦྱོར
SDANG	སྡང
SDE	སྡེ
SDE'I	སྡེའི
SDES	སྡེས
SDIG	སྡིག
SDOD	སྡོད
SDOM	སྡོམ
SDONG	སྡོང
SDUD	སྡུད
SDUG	སྡུག
SE'U	སེའུ
SEL	སེལ
SEMS	སེམས
SEN	སེན
SENG	སེང
SENGGE	སེངྒེ
SENGGE'I	སེངྒེའི
SER	སེར
SGER	སྒེར
SGO	སྒོ
SGOM	སྒོམ
SGOR	སྒོར
SGRA	སྒྲ
SGRA'I	སྒྲའི
SGRAS	སྒྲས
SGRIB	སྒྲིབ
SGRIBS	སྒྲིབས
SGRIG	སྒྲིག
SGRO	སྒྲོ
SGROG	སྒྲོག
SGROGS	སྒྲོགས
SGROL	སྒྲོལ
SGRON	སྒྲོན
SGRUB	སྒྲུབ
SGYU	སྒྱུ
SGYUR	སྒྱུར
SH'A	ཤཱ
SH'AKYA	ཤཱཀྱ
SH'AKYA'I	ཤཱཀྱའི
SH'ASTRA	ཤཱསྟྲ
SH'I	ཤཱི
SHA	ཤ
SHAD	ཤད
SHAL	ཤལ
SHANGS	ཤངས
SHAR	ཤར
SHAS	ཤས
SHE	ཤེ
SHE'I	ཤེའི
SHEL	ཤེལ
SHER	ཤེར
SHES	ཤེས
SHI	ཤི
SHI'I	ཤིའི
SHIG	ཤིག
SHIN	ཤིན
SHING	ཤིང
SHIS	ཤིས
SHLOO	ཤླཽ
SHO	ཤོ
SHOD	ཤོད
SHOG	ཤོག
SHOR	ཤོར
SHOS	ཤོས
SHR'I	ཤྲཱི
SHU	ཤུ
SHU'I	ཤུའི
SHU'O	ཤུའོ
SHUGS	ཤུགས
SHUL	ཤུལ
SHUN	ཤུན
SHUR	ཤུར
SIL	སིལ
SIM	སིམ
SKABS	སྐབས
SKAD	སྐད
SKAL	སྐལ
SKAM	སྐམ
SKAMS	སྐམས
SKAN	སྐན
SKAR	སྐར
SKOM	སྐོམ
SKONG	སྐོང
SKOR	སྐོར
SKRA	སྐྲ
SKRAG	སྐྲག
SKU	སྐུ
SKU'I	སྐུའི
SKUD	སྐུད
SKUL	སྐུལ
SKUM	སྐུམ
SKUR	སྐུར
SKUS	སྐུས
SKYABS	སྐྱབས
SKYE	སྐྱེ
SKYE'AM	སྐྱེའམ
SKYE'I	སྐྱེའི
SKYE'O	སྐྱེའོ
SKYED	སྐྱེད
SKYEL	སྐྱེལ
SKYES	སྐྱེས
SKYID	སྐྱིད
SKYIL	སྐྱིལ
SKYO	སྐྱོ
SKYOB	སྐྱོབ
SKYON	སྐྱོན
SKYONG	སྐྱོང
SKYONGS	སྐྱོངས
SKYOR	སྐྱོར
SKYU	སྐྱུ
SKYUGS	སྐྱུགས
SKYUNGS	སྐྱུངས
SKYUR	སྐྱུར
SLA	སླ
SLA'I	སླའི
SLA'O	སླའོ
SLAD	སླད
SLAR	སླར
SLEB	སླེབ
SLEBS	སླེབས
SLOB	སློབ
SLONG	སློང
SLU	སླུ
SMAD	སྨད
SMAN	སྨན
SME	སྨེ
SMIG	སྨིག
SMIN	སྨིན
SMOD	སྨོད
SMON	སྨོན
SMOS	སྨོས
SMRA	སྨྲ
SMRA'I	སྨྲའི
SMRA'O	སྨྲའོ
SMRAS	སྨྲས
SMRE	སྨྲེ
SMRIG	སྨྲིག
SMROS	སྨྲོས
SMYON	སྨྱོན
SMYUG	སྨྱུག
SNA	སྣ
SNA'I	སྣའི
SNAM	སྣམ
SNANG	སྣང
SNGA	སྔ
SNGAGS	སྔགས
SNGAR	སྔར
SNGO	སྔོ
SNGON	སྔོན
SNGOR	སྔོར
SNOD	སྣོད
SNOM	སྣོམ
SNUM	སྣུམ
SNYAD	སྙད
SNYAM	སྙམ
SNYAN	སྙན
SNYED	སྙེད
SNYEG	སྙེག
SNYIGS	སྙིགས
SNYING	སྙིང
SNYOM	སྙོམ
SNYOMS	སྙོམས
SO	སོ
SO'I	སོའི
SOG	སོག
SOGS	སོགས
SOM	སོམ
SON	སོན
SONG	སོང
SOR	སོར
SOS	སོས
SPANG	སྤང
SPANGS	སྤངས
SPEL	སྤེལ
SPO	སྤོ
SPOBS	སྤོབས
SPOM	སྤོམ
SPONG	སྤོང
SPONGS	སྤོངས
SPRAS	སྤྲས
SPRE'U	སྤྲེའུ
SPRIN	སྤྲིན
SPRING	སྤྲིང
SPRO	སྤྲོ
SPROS	སྤྲོས
SPRUL	སྤྲུལ
SPU	སྤུ
SPU'I	སྤུའི
SPUBS	སྤུབས
SPUN	སྤུན
SPUNGS	སྤུངས
SPUS	སྤུས
SPYAD	སྤྱད
SPYAN	སྤྱན
SPYI	སྤྱི
SPYI'I	སྤྱིའི
SPYIR	སྤྱིར
SPYOD	སྤྱོད
SRA	སྲ
SRAB	སྲབ
SRANG	སྲང
SRAS	སྲས
SRED	སྲེད
SREG	སྲེག
SREGS	སྲེགས
SRID	སྲིད
SRIN	སྲིན
SRING	སྲིང
SROG	སྲོག
SROL	སྲོལ
SRONG	སྲོང
SRUNG	སྲུང
SRUNGS	སྲུངས
STABS	སྟབས
STAN	སྟན
STANGS	སྟངས
STAR	སྟར
STE	སྟེ
STEGS	སྟེགས
STEN	སྟེན
STENG	སྟེང
STER	སྟེར
STHI	སྠི
STI	སྟི
STOBS	སྟོབས
STOD	སྟོད
STON	སྟོན
STONG	སྟོང
STOS	སྟོས
STRA	སྟྲ
STUG	སྟུག
STZAL	སྩལ
STZOL	སྩོལ
SU	སུ
SU'ANG	སུའང
SU'I	སུའི
SUL	སུལ
SUM	སུམ
SUN	སུན
SUS	སུས
SVA	སྭ
T'A	ཏཱ
T'IK	ཏཱིཀ
T'IKKA	ཏཱིཀྐ
TA	ཏ
TAM	ཏམ
TAN	ཏན
TANTRA	ཏནྟྲ
TE	ཏེ
THA	ཐ
THABS	ཐབས
THAD	ཐད
THAG	ཐག
THAGS	ཐགས
THAL	ཐལ
THAM	ཐམ
THAMS	ཐམས
THANG	ཐང
THAR	ཐར
THE	ཐེ
THEBS	ཐེབས
THEG	ཐེག
THER	ཐེར
THIBS	ཐིབས
THIG	ཐིག
THIGS	ཐིགས
THO	ཐོ
THOB	ཐོབ
THOD	ཐོད
THOG	ཐོག
THOGS	ཐོགས
THON	ཐོན
THOS	ཐོས
THU	ཐུ
THUB	ཐུབ
THUG	ཐུག
THUGS	ཐུགས
THUL	ཐུལ
THUN	ཐུན
THUNG	ཐུང
THUR	ཐུར
TI	ཏི
TIK	ཏིཀ
TIL	ཏིལ
TING	ཏིང
TO	ཏོ
TOG	ཏོག
TOR	ཏོར
TRA	ཏྲ
TSA	ཚ
TSAB	ཚབ
TSAD	ཚད
TSAL	ཚལ
TSAN	ཚན
TSANG	ཚང
TSANGS	ཚངས
TSAR	ཚར
TSE	ཚེ
TSE'I	ཚེའི
TSED	ཚེད
TSEGS	ཚེགས
TSEMS	ཚེམས
TSES	ཚེས
TSIG	ཚིག
TSIGS	ཚིགས
TSIM	ཚིམ
TSO	ཚོ
TSO'I	ཚོའི
TSOD	ཚོད
TSOGS	ཚོགས
TSOL	ཚོལ
TSOM	ཚོམ
TSON	ཚོན
TSONG	ཚོང
TSOR	ཚོར
TSU	ཚུ
TSUGS	ཚུགས
TSUL	ཚུལ
TSUN	ཚུན
TSUR	ཚུར
TSVA	ཚྭ
TU	ཏུ
TU'O	ཏུའོ
TZ'A	ཙཱ
TZAM	ཙམ
TZAN	ཙན
TZANDRA	ཙནྡྲ
TZONG	ཙོང
TZTSA	ཙྪ
WA	ཝ
WARMA	ཝརྨ
Y'A	ཡཱ
YA	ཡ
YA'I	ཡའི
YAB	ཡབ
YAL	ཡལ
YAMS	ཡམས
YAN	ཡན
YANG	ཡང
YANGS	ཡངས
YAR	ཡར
YAS	ཡས
YE	ཡེ
YI	ཡི
YI'ANG	ཡིའང
YID	ཡིད
YIG	ཡིག
YIN	ཡིན
YIR	ཡིར
YIS	ཡིས
YO	ཡོ
YOD	ཡོད
YON	ཡོན
YONGS	ཡོངས
YOR	ཡོར
YUD	ཡུད
YUL	ཡུལ
YUM	ཡུམ
YUN	ཡུན
ZA	ཟ
ZA'I	ཟའི
ZAB	ཟབ
ZAD	ཟད
ZAG	ཟག
ZANG	ཟང
ZANGS	ཟངས
ZAR	ཟར
ZAS	ཟས
ZE	ཟེ
ZE'I	ཟེའི
ZE'U	ཟེའུ
ZER	ཟེར
ZHABS	ཞབས
ZHAGS	ཞགས
ZHAL	ཞལ
ZHAN	ཞན
ZHAR	ཞར
ZHE	ཞེ
ZHE'AM	ཞེའམ
ZHE'O	ཞེའོ
ZHEN	ཞེན
ZHENG	ཞེང
ZHES	ཞེས
ZHI	ཞི
ZHI'I	ཞིའི
ZHIB	ཞིབ
ZHIG	ཞིག
ZHIM	ཞིམ
ZHING	ཞིང
ZHIR	ཞིར
ZHIS	ཞིས
ZHO	ཞོ
ZHOG	ཞོག
ZHON	ཞོན
ZHOR	ཞོར
ZHU	ཞུ
ZHUGS	ཞུགས
ZHUM	ཞུམ
ZHUN	ཞུན
ZHUS	ཞུས
ZHVA	ཞྭ
ZIL	ཟིལ
ZIN	ཟིན
ZING	ཟིང
ZLA	ཟླ
ZLOG	ཟློག
ZLOS	ཟློས
ZLUM	ཟླུམ
ZO	ཟོ
ZOS	ཟོས
ZUG	ཟུག
ZUM	ཟུམ
ZUNG	ཟུང
ZUNGS	ཟུངས
ZUR	ཟུ
dA	ཌ
dhA	ཌྷ
shA	ཥ
tA	ཊ
thA	ཋ
